border_size=1
usage=map

Gs^Fp       , Gs^Fp       , Gs^Fp       , Gs^Fp       , Hh          , Hh          , Gs^Fp       , Gs^Fp       , Gs^Fp       , Gs^Fp       , Gs^Fp       , Gs^Fp       , Re          , Re          , Gs^Fp       , Gs^Fp       , Gs^Fp       , Gs^Fp       , Gs^Fp       , Gs^Fp       , Gs^Fp       , Gs^Fp       
Gs^Fp       , Gs^Fp       , Gs^Fp       , Gs^Fp       , Hh          , Hh          , Gs^Fp       , Gs^Fp       , Gg^Fet      , Gs^Fp       , Gs^Fp       , Gs^Fp       , Re          , Re          , Gs^Fp       , Gs^Fp       , Gs^Fp       , Gs^Fp       , Gs^Fp       , Gs^Fp       , Gs^Fp       , Gs^Fp       
Gs^Fp       , Gg^Fet      , Gs^Fp       , Gs^Fp       , Re          , Gs^Fp       , Re          , Gs^Fp       , Hh          , Gs^Fp       , Hh          , Re          , Gs^Fp       , Re          , Gs^Fp       , Gg^Fet      , Gg          , Hh          , Gg          , Gg^Ve       , Gs^Fp       , Gs^Fp       
Gs^Fp       , Gs^Fp       , Gs^Fp       , Re          , Cv          , Re          , Gs^Fp       , Re          , Re          , Re          , Re          , Re          , Gs^Fp       , Re          , Re          , Ggf         , Gs^Fp       , Gs^Fp       , Gg          , Ggf         , Gg          , Gg          
Gs^Fp       , Gs^Fp       , Cv          , 1 Kv        , Cv          , Gs^Fp       , Gs^Fp       , Gg^Ve       , Gs^Fp       , Gs^Fp       , Re          , Gs^Fp       , Hh          , Hh          , Cv          , Re          , Gg          , Gs^Fp       , Gs^Fp       , Gg          , Gg          , Gg          
Gs^Fp       , Gs^Fp       , Gg          , Cv          , Gg          , Ggf         , Hh          , Gs^Fp       , Hh          , Hh          , Re          , Gs^Fp       , Gs^Fp       , Gs^Fp       , Cv          , 2 Kv        , Cv          , Gg          , Gs^Fp       , Gs^Fp       , Ggf         , Ggf         
Gs^Fp       , Gs^Fp       , Ggf         , Gg          , Hh          , Hh          , Gg          , Gs^Fp       , Gs^Fp       , Re          , Hh          , Gs^Fp       , Gg          , Ggf         , Gg          , Cv          , Gg          , Hh          , Gs^Fp       , Gs^Fp       , Gg^Fet      , Gs^Fp       
Gs^Fp       , Gs^Fp       , Gg^Ve       , Gg          , Hh          , Gg^Fet      , Ggf         , Gs^Fp       , Hh          , Re          , Hh          , Gg          , Hh          , Gs^Fp       , Gg^Fet      , Gs^Fp       , Gg          , Gs^Fp       , Gg          , Gs^Fp       , Gs^Fp       , Gs^Fp       
Gs^Fp       , Gs^Fp       , Gs^Fp       , Gs^Fp       , Hh          , Gs^Fp       , Gs^Fp       , Gs^Fp       , Gs^Fp       , Re          , Re          , Hh^Vhh      , Hh          , Gs^Fp       , Gs^Fp       , Ggf         , Gs^Fp       , Hh          , Hh          , Gg^Ve       , Gs^Fp       , Gs^Fp       
Gs^Fp       , Gs^Fp       , Ggf         , Hh          , Gg          , Hh          , Gs^Fp       , Gs^Fp       , Gs^Fp       , Gs^Fp       , Gs^Fp       , Re          , Re          , Ggf         , Gg          , Gs^Fp       , Gs^Fp       , Gs^Fp       , Gg          , Gg          , Gg          , Gg          
Gg          , Gg          , Gg          , Gg          , Gg          , Gg^Vh       , Gg          , Ggf         , Gg^Fet      , Hh          , Gs^Fp       , Gs^Fp       , Mm          , Re          , Gg          , Gg          , Gg          , Ggf         , Hh          , Gg          , Gg          , Gg          
Gg          , Gg          , Gg          , Gg          , Gg          , Gg          , Gg          , Gg          , Hh          , Hh          , Gg^Ve       , Hh          , Mm          , Re          , Gs^Fp       , Gs^Fp       , Gs^Fp       , Gg          , Gg          , Hh          , Gg^Ve       , Gg          
Gg          , Gg          , Hh          , Hh          , Hh          , Gg          , Hh          , Gg          , Gg          , Gg          , Gg          , Hh          , Hh          , Re          , Gs^Fp       , Gs^Fp       , Gg          , Gs^Fp       , Gg          , Hh          , Gg          , Gg          
Gg          , Gg          , Gg          , Hh          , Gs^Fp       , Gg^Ve       , Gs^Fp       , Gg          , Hh          , Hh          , Hh          , Gg          , Gg          , Re          , Re          , Gg^Ve       , Gg          , Gg          , Gg          , Hh          , Gg          , Gg          
Gg          , Gg          , Gg          , Gg          , Gs^Fp       , Gs^Fp       , Gs^Fp       , Ggf         , Gs^Fp       , Gg          , Hh          , Hh          , Cud         , Cud         , Re          , Hh          , Gg          , Gg          , Hh          , Gg          , Hh          , Hh          
Hh          , Hh          , Hh          , Gg          , Gg          , Gg          , Gg          , Gs^Fp       , Gg^Vh       , Gg          , Gg          , Gg          , Cud         , 4 Kud       , Gg          , Re          , Re          , Gg          , Hh          , Hh          , Gg          , Gg          
Gg          , Gg          , Hh          , Gg          , Cud         , Gg          , Hh          , Hh          , Gg          , Gg          , Hh          , Hh          , Hh          , Cud         , Gg          , Gg^Vh       , Gs^Fp       , Re          , Hh          , Gg          , Hh          , Hh          
Gg          , Gg          , Gs^Fp       , Cud         , 3 Kud       , Cud         , Gg          , Gg          , Gg          , Gg          , Gs^Fp       , Hh          , Gg          , Gs^Fp       , Gs^Fp       , Gs^Fp       , Gs^Fp       , Re          , Cud         , Cud         , Cud         , Mm          
Gg          , Gg          , Gs^Fp       , Gs^Fp       , Hh          , Cud         , Hh          , Hh          , Hh          , Gs^Fp       , Gs^Fp       , Gs^Fp       , Gs^Fp       , Gs^Fp       , Mm          , Gs^Fp       , Gs^Fp       , Re          , Re          , 5 Kud       , Cud         , Hh          
Gs^Fp       , Gs^Fp       , Gs^Fp       , Gs^Fp       , Gs^Fp       , Hh          , Mm          , Hh^Vhh      , Hh          , Hh          , Hh          , Gs^Fp       , Hh          , Hh^Vhh      , Hh          , Gs^Fp       , Gs^Fp       , Hh          , Hh          , Re          , Mm          , Mm          
Hh          , Hh          , Hh          , Hh^Vhh      , Hh          , Gs^Fp       , Hh          , Mm          , Hh          , Mm          , Hh          , Mm          , Mm          , Mm          , Mm          , Mm          , Mm          , Mm^Vhh      , Mm          , Re          , Re          , Re          
Hh          , Hh          , Hh          , Hh          , Hh          , Gs^Fp       , Hh          , Mm          , Hh          , Mm          , Hh          , Mm          , Mm          , Mm          , Mm          , Mm          , Mm          , Mm          , Mm          , Re          , Re          , Re          
