border_size=1
usage=map

Gs^Fp       , Gs^Fp       , Gg          , Gs^Fp       , Gs          , Gs^Fp       , Hh          , Gg          , Hh          , Gg          , Gg          
Gs^Fp       , Gg^Fet      , Gg^Efm      , Gs^Fp       , Gs          , Gs^Fp       , Hh          , Gg          , Hh          , Gg          , Gg          
Gs^Fp       , Gs^Fp       , Gg          , Gs^Fp       , Gg          , Gg^Fet      , Gg          , Gs^Fp       , Cv          , Gg^Efm      , Gg^Efm      
Gg^Efm      , Gg^Efm      , Gs          , Gg          , Gs^Fp       , Gg^Efm      , Gs^Fp       , Gs          , Ww          , Ww          , Ww          
Gs^Fp       , 1 Gs^Fp     , Rr          , Gg^Fet      , Rr          , Rr          , Rr          , Rr          , Ww^Bw\      , Gg^Fet      , Gs^Fp       
Rr          , Rr          , Gg^Efm      , Rr          , Gs          , Cv          , Ww          , Ww          , Gg^Efm      , 2 Rr        , Rr          
Gs          , Gs          , Gg          , Gg^Fet      , Gs^Fp       , Gg^Efm      , Wwf         , Gs^Fp       , Gs          , Gg          , Gg          
Gs^Fp       , Gs^Fp       , Gg^Efm      , Gs          , Gg^Fet      , Gg          , Ww          , Gg          , Gg^Efm      , Gs^Fp       , Gs^Fp       
Gs^Fp       , Gg^Fet      , Cv          , Gs^Fp       , Ww          , Ww          , Hh          , Gg^Efm      , Gs          , Gg^Fet      , Gs^Fp       
Gs^Fp       , Gs^Fp       , Cv          , Gs^Fp       , Ww          , Ww          , Hh          , Gg^Efm      , Gs          , Gs^Fp       , Gs^Fp       
