border_size=1
usage=map

Xu          ,Xu          , Xu          , Xu          , Xu          , Xu          , Xu          , Xu          , Xu          , Xu          , Xu          , Xu          , Uu^Uf       , Xu          , Xu          , Xu          , Xu          , Xu          , Xu          , Xu          , Xu          , Xu          
Xu          ,Xu          , Xu          , Xu          , Xu          , Xu          , Xu          , Xu          , Xu          , Xu          , Xu          , Xu          , Uu^Uf       , Xu          , Xu          , Xu          , Xu          , Xu          , Xu          , Xu          , Xu          , Xu          
Xu          ,Xu          , Xu          , Xu          , Uu          , Uu^Vu       , Uh          , Xu          , Uu^Ii       , Uu^Uf       , Uu^Ii       , Uh^Ii       , Qxu         , Uu^Uf       , Xu          , Xu          , Uu^Uf       , Uu^Vu       , Xu          , Xu          , Xu          , Xu          
Cud         ,Cud         , Re^Uf       , Re          , Re          , Re          , Re          , Re          , Uu^Uf       , Uu^Ii       , Re          , Qxu         , Qxu         , Uh          , Re          , Re          , Re          , Xu          , Xu          , Xu          , Xu          , Xu          
Cud         ,Cud         , Re          , Uu^Ii       , Xu          , Uu^Uf       , Uu          , Uu^Uf       , Uh          , Xu          , Uu^Vu       , Qxu         , Uh          , Uh^Ii       , Uh          , Uu^Uf       , Uh          , Xu          , Xu          , Xu          , Xu          , Xu          
Cud       ,3 Kud       , Uh          , Uu^Vud      , Xu          , Uu^Vud      , Xu          , Re          , Re          , Uh^Ii       , Uu^Ii       , Re          , Uu^Ii       , Xu          , Xu          , Xu          , Re          , Uh          , Xu          , Xu          , Xu          , Xu          
Cud         ,Cud         , Xu          , Xu          , Xu          , Xu          , Xu          , Xu          , Xu          , Uu^Ii       , Re          , Re          , Uu^Uf       , Xu          , Uh          , Uu^Vud      , Re          , Uu^Uf       , Xu          , Xu          , Xu          , Xu          
Xu          ,Xu          , Xu          , Xu          , Xu          , Xu          , Xu          , Xu          , Xu          , Uu^Vud      , Re          , Uu          , Xu          , Xu          , Uu^Ii       , Re          , Xu          , Uh          , Xu          , Xu          , Xu          , Xu          
Xu          ,Xu          , Xu          , Xu          , Xu          , Xu          , Xu          , Xu          , Xu          , Uu          , Uu          , Uu^Uf       , Uu^Ii       , Uh          , Re          , Uh^Ii       , Xu          , Xu          , Xu          , Xu          , Xu          , Xu          
Xu          ,Xu          , Uu^Vu       , Xu          , Xu          , Xu          , Uu^Vu       , Xu          , Xu          , Uu^Ii       , Re          , Re          , Uu^Vu       , Uu^Uf       , Uu          , Uu          , Re          , Xu          , Xu          , Xu          , Xu          , Xu          
Xu          ,Xu          , Uh          , Uu^Uf       , Re          , Uh          , Uu^Uf       , Uu^Ii       , Uu^Ii       , Uu^Uf       , Re          , Xu          , Xu          , Xu          , Xu          , Uu^Uf       , Re          , Uu^Uf       , Xu          , Xu          , Xu          , Xu          
Xu          ,Xu          , Uu^Uf       , Uh^Ii       , Uu^Uf       , Re          , Re          , Re          , Uu^Uf       , Uu^Ii       , Re          , Uu^Ii       , Qxu         , Qxu         , Qxu         , Uh^Ii       , Uu          , Uh          , Xu          , Xu          , Xu          , Xu          
Xu          ,Xu          , Xu          , Uu^Vud      , Xu          , Xu          , Uu          , Uu          , Xu          , Uh          , Xu          , Uh^Ii       , Uh          , Qxu         , Uu^Uf       , Uu          , Re          , Xu          , Xu          , Xu          , Xu          , Xu          
Xu          ,Xu          , Xu          , Xu          , Uh          , Uu^Uf       , Re          , Uu^Vu       , Xu          , Xu          , Re          , Re          , Uu          , Uh          , Uu          , Uu          , Uu^Vu       , Uu^Uf       , Uu^Ii       , Xu          , Xu          , Xu          
Xu          ,Xu          , Xu          , Xu          , Uu^Uf       , Re          , Xu          , Xu          , Uh          , Uu^Vud      , Uu          , Uu^Ii       , Uu^Uf       , Uu          , Xu          , Xu          , Xu          , Re          , Uu          , Uh          , Xu          , Xu          
Xu          ,Xu          , Xu          , Xu          , Uu^Uf       , Uu^Ii       , Re          , Xu          , Re          , Re          , Xu          , Uu^Uf       , Xu          , Xu          , Xu          , Xu          , Re          , Uu^Uf       , Uh          , Qxu         , Xu          , Xu          
Xu          ,Xu          , Uh          , Uu^Vud      , Uh          , Uu          , Uh^Ii       , Re          , Uu          , Uu^Uf       , Xu          , Xu          , 1 Kud       , Xu          , Xu          , Uu          , Uu^Ii       , Uh^Ii       , Qxu         , Qxu         , Xu          , Xu          
Xu          ,Xu          , Re          , Uu^Ii       , Xu          , Xu          , Xu          , Uh          , Re          , Re          , Uu^Ii       , Cud         , Cud         , Cud         , Uu^Vud      , Re          , Uh          , Qxu         , Xu          , Xu          , Xu          , Xu          
Xu          ,Xu          , Uu^Uf       , Uh          , Xu          , Xu          , Re          , Uu^Uf       , Xu          , Uh^Ii       , Uu^Vu       , Cud         , 2 Kud       , Cud         , Uh^Ii       , Uu          , Uu^Uf       , Xu          , Xu          , Xu          , Xu          , Xu          
Xu          ,Xu          , Uu^Vu       , Uu^Ii       , Re          , Uu^Uf       , Uh          , Uu^Uf       , Xu          , Xu          , Xu          , Uu^Ii       , Uu^Ii       , Uu^Ii       , Xu          , Xu          , Xu          , Xu          , Xu          , Xu          , Xu          , Xu          
Xu          ,Xu          , Xu          , Uu^Uf       , Xu          , Uh          , Xu          , Uu^Vud      , Xu          , Xu          , Xu          , Re^Uf       , Re          , Re^Uf       , Xu          , Xu          , Xu          , Xu          , Xu          , Xu          , Xu          , Xu          
Xu          ,Xu          , Xu          , Uu^Uf       , Xu          , Uh          , Xu          , Uu      , Xu          , Xu          , Xu          , Re^Uf       , Re          , Re^Uf       , Xu          , Xu          , Xu          , Xu          , Xu          , Xu          , Xu          , Xu          
