border_size=1
usage=map

Gs^Fp       , Gs^Fp       , Gs^Fp       , Gs^Fp       , Gg          , Gs^Fp       , Gg          , Gs^Fp       , Gs^Fp       , Gs^Fp       , Gs^Fp       , Gs^Fp       , Gs^Fp       , Gs^Fp       , Gg          , Gs^Fp       , Ds          , Ds          , Ww          , Ww          , Ww          , Ww          , Ww          , Ds          , Ds          , Gs^Fp       , Gs^Fp       , Gs^Fp       , Gs^Fp       , Gs^Fp       , Gs^Fp       , Gs^Fp       , Gs^Fp       , Gs^Fp       , Gs^Fp       , Gs^Fp       , Gs^Fp       , Gs^Fp       , Gs^Fp       , Gs^Fp       , Gs^Fp       , Gs^Fp       
Gs^Fp       , Gs^Fp       , Gs^Fp       , Gg^Vh       , Gg          , Gs^Fp       , Gg          , Gs^Fp       , Gs^Fp       , Gs^Fp       , Gs^Fp       , Gs^Fp       , Gs^Fp       , Gs^Fp       , Gg          , Gs^Fp       , Ds          , Ds          , Wwf         , Ww          , Ww          , Ww          , Ww          , Ds          , Ds          , Gs^Fp       , Gs^Fp       , Gs^Fp       , Gs^Fp       , Gs^Fp       , Gs^Fp       , Gs^Fp       , Gs^Fp       , Gs^Fp       , Gs^Fp       , Gs^Fp       , Gs^Fp       , Gs^Fp       , Gs^Fp       , Gs^Fp       , Gs^Fp       , Gs^Fp       
Gs^Fp       , Gs^Fp       , Gs^Fp       , Gg          , 2 Ke        , Gg          , Gg          , Gg          , Gg          , Gg          , Gg^Ve       , Gs^Fp       , Gs^Fp       , Gg          , Ds          , Ds          , Ww          , Wwf         , Wwf         , Ww          , Ww          , Ww          , Wwf         , Wwf         , Ww          , Ds          , Ds          , Gs^Fp       , Gg^Ve       , Gs^Fp       , Gg          , Gs^Fp       , Hh          , Gs^Fp       , Gg          , Hh^Vhh      , Hh          , Hh          , Gs^Fp       , Gs^Fp       , Gs^Fp       , Gs^Fp       
Gs^Fp       , Gs^Fp       , Gg          , Gg          , Ce          , Ce          , Gg          , Gg          , Gg          , Gg          , Gg          , Gs^Fp       , Gg          , Gg          , Ds          , Ww          , Ww          , Wwf         , Wwf         , Ww          , Ww          , Ww          , Wwf         , Wwf         , Ww          , Ww          , Ww          , Ds          , Ds          , Gs^Fp       , Gg          , Hh          , Hh          , Gg          , Gg          , Gg          , Gg          , Gs^Fp       , Gg          , Gs^Fp       , Gs^Fp       , Gs^Fp       
Gs^Fp       , Gs^Fp       , Gg^Ve       , Gg          , Gg          , Ce          , Hh          , Hh          , Gg          , Gg          , Ds          , Ds          , Ds          , Ds          , Wwf         , Wwf         , Wwf         , Wwf         , Wwf         , Ww          , Ww          , Ww          , Ww          , Wwf         , Wwf         , Ww          , Ww          , Ww          , Ds          , Gg          , Gg          , Hh          , Gs^Fp       , Gg          , Gg          , Gg          , Gg          , Gg          , Gg          , Gs^Fp       , Gs^Fp       , Gs^Fp       
Gs^Fp       , Gs^Fp       , Gs^Fp       , Gg          , Gg          , Gg          , Hh          , Gg          , Gg          , Ds          , Wwf         , Wwf         , Ww          , Wwf         , Wwf         , Wwf         , Ds          , Ds          , Ds          , Ww          , Ds          , Ww          , Ww          , Wwf         , Wwf         , Ww          , Ww          , Ww          , Ww          , Ds          , Ds          , Gs^Fp       , Hh          , Gg          , Ce          , 3 Ke        , Gg          , Gg          , Gs^Fp       , Gg^Ve       , Gs^Fp       , Gs^Fp       
Gs^Fp       , Gs^Fp       , Gs^Fp       , Gg          , Gg          , Hh          , Hh          , Gg          , Gg          , Ds          , Wwf         , Wwf         , Ww          , Ww          , Ww          , Ds          , Ch          , Ch          , Ch          , Ds          , Ch          , Ds          , Ds          , Wwf         , Ds          , Ww          , Ww          , Ww          , Wwf         , Wwf         , Ds          , Gg          , Hh          , Gg          , Ce          , Ce          , Gg          , Gg          , Gg          , Gg          , Gg          , Gg          
Gs^Fp       , Gs^Fp       , Hh          , Gs^Fp       , Gg          , Gs^Fp       , Gs^Fp       , Gg          , Gg          , Ds          , Wwf         , Wwf         , Wwf         , Ww          , Wwf         , Ds          , Ch          , Gg^Vh       , Rr          , Ch          , Gs^Fp       , Ch          , Ch          , Ds          , Ch          , Ds          , Ds          , Wwf         , Wwf         , Wwf         , Ds          , Hh          , Gg          , Gg          , Gg          , Gg          , Gg          , Gg          , Gg          , Gg          , Gg          , Gg          
Hh          , Hh          , Gg          , Hh^Vhh      , Hh          , Gg          , Gg          , Gs^Fp       , Gg^Vh       , Ds          , Wwf         , Wwf         , Ww          , Wwf         , Wwf         , Ds          , Ch          , Gs^Fp       , Gs^Fp       , Rr          , Rr          , Gs^Fp       , Gs^Fp       , Ch          , Gg^Ve       , Ch          , Ds          , Wwf         , Ww          , Wwf         , Wwf         , Ds          , Ds          , Gg          , Hh          , Gg          , Gg          , Gs^Fp       , Hh          , Hh          , Gg          , Gg          
Gs^Fp       , Gs^Fp       , Gs^Fp       , Gg          , Hh          , Gg          , Gg          , Gs^Fp       , Gg          , Ds          , Wwf         , Wwf         , Ww          , Ww          , Ww          , Ds          , Ds          , Ch          , Gs^Fp       , Gs^Fp       , Rr          , Gg^Ve       , Gs^Fp       , Gs^Fp       , Rr          , Ch          , Ds          , Ww          , Ww          , Ww          , Wwf         , Wwf         , Ds          , Gg^Vh       , Hh          , Gs^Fp       , Gs^Fp       , Gs^Fp       , Gs^Fp       , Hh          , Gg^Vh       , Gg          
Gg          , Gg          , Gg          , Gs^Fp       , Gg          , Gg          , Gg          , Gs^Fp       , Gs^Fp       , Ds          , Ds          , Wwf         , Wwf         , Wwf         , Wwf         , Wwf         , Ds          , Ch          , Gg^Vh       , Gs^Fp       , Rr          , Rr          , Rr          , Gs^Fp       , Rr          , Ch          , Ch          , Ds          , Ds          , Ww          , Wwf         , Wwf         , Wwf         , Ds          , Ds          , Gg          , Gg          , Gs^Fp       , Gs^Fp       , Hh          , Gg          , Gg          
Gs^Fp       , Gs^Fp       , Gg^Ve       , Gs^Fp       , Hh          , Gg          , Gg          , Gs^Fp       , Gg          , Gg          , Ds          , Wwf         , Wwf         , Wwf         , Ww          , Ww          , Ds          , Ch          , Ch          , Rr          , Rr          , Hh          , Hh          , Rr          , Rr          , Gg^Vh       , Rr          , Ch          , Ch          , Ds          , Ds          , Wwf         , Wwf         , Wwf         , Ww          , Ds          , Gg          , Hh          , Gg          , Hh          , Gg          , Gg          
Gs^Fp       , Gs^Fp       , Gs^Fp       , Gs^Fp       , Gs^Fp       , Hh          , Hh          , Gg          , Gg          , Gg          , Ds          , Wwf         , Ww          , Ww          , Wwf         , Wwf         , Ww          , Ds          , Ch          , 5 Kh        , Rr          , Hh          , Gs^Fp       , Gs^Fp       , Gs^Fp       , Rr          , Rr          , Gs^Fp       , 4 Kh        , Ch          , Ds          , Wwf         , Ww          , Ww          , Ww          , Ds          , Ds          , Gg          , Ds          , Gg          , Gg          , Gg          
Gg          , Gg          , Gs^Fp       , Hh          , Hh          , Hh          , Hh          , Gs^Fp       , Gg          , Gg          , Gg          , Ds          , Ds          , Wwf         , Ww          , Ww          , Wwf         , Ds          , Ds          , Ch          , Ch          , Rr          , Hh          , Hh          , Gs^Fp       , Gs^Fp       , Rr          , Gs^Fp       , Rr          , Ch          , Ch          , Ds          , Ww          , Ww          , Wwf         , Wwf         , Wwf         , Ds          , Ww          , Ds          , Ds          , Ds          
Gs^Fp       , Gs^Fp       , Gg          , Gs^Fp       , Gg^Ve       , Gs^Fp       , Gs^Fp       , Gs^Fp       , Hh          , Hh          , Hh          , Gg          , Gg          , Ds          , Ww          , Wwf         , Wwf         , Wwf         , Wwf         , Ds          , Ch          , Gg^Ve       , Gs^Fp       , Hh          , Gs^Fp       , Gs^Fp       , Gg^Ve       , Rr          , Hh          , Rr          , Ch          , Ds          , Ds          , Wwf         , Wwf         , Wwf         , Ww          , Ww          , Ww          , Ww          , Ww          , Ww          
Gs^Fp       , Gs^Fp       , Gs^Fp       , Gs^Fp       , Gs^Fp       , Gs^Fp       , Gs^Fp       , Hh          , Gs^Fp       , Gg^Vh       , Gg          , Gg          , Gg          , Ds          , Ds          , Ds          , Ds          , Wwf         , Wwf         , Ds          , Ds          , Ch          , Gs^Fp       , Gs^Fp       , Gs^Fp       , Gs^Fp       , Rr          , Rr          , Hh          , Rr          , Gs^Fp       , Ch          , Ds          , Wwf         , Ww          , Ww          , Ww          , Ww          , Ww          , Ww          , Ww          , Ww          
Gs^Fp       , Gs^Fp       , Gg          , Gs^Fp       , Gs^Fp       , Gs^Fp       , Gg          , Hh          , Hh          , Gg          , Gg          , Gg          , Hh          , Hh          , Hh          , Gg^Vh       , Ds          , Wwf         , Ww          , Ww          , Ds          , Ch          , Ch          , Gs^Fp       , Gg^Vh       , Rr          , Gs^Fp       , Hh          , Gs^Fp       , Rr          , Gg^Ve       , Ch          , Ds          , Ww          , Ww          , Ww          , Wo          , Wo          , Wo          , Wo          , Wo          , Wo          
Gs^Fp       , Gs^Fp       , Gg          , Gg          , Ce          , Gg          , Gg          , Hh          , Hh          , Hh          , Gg          , Gs^Fp       , Gs^Fp       , Hh          , Gs^Fp       , Gg          , Ds          , Ww          , Ww          , Ww          , Wwf         , Ds          , Ds          , Ch          , Ch          , Gs^Fp       , Ch          , Gs^Fp       , Ch          , Gs^Fp       , Ch          , Ch          , Ds          , Ww          , Ww          , Wo          , Wo          , Wo          , Wo          , Wo          , Wo          , Wo          
Gs^Fp       , Gs^Fp       , Gg          , Ce          , Ce          , Gg          , Gg          , Gg          , Gg          , Hh          , Hh          , Gg          , Gg          , Gs^Fp       , Gg          , Ds          , Wwf         , Wwf         , Wwf         , Wwf         , Wwf         , Wwf         , Ww          , Ds          , Ds          , Ch          , Ds          , Ch          , Ds          , Ch          , Ds          , Ds          , Ww          , Ww          , Ww          , Wo          , Wo          , Wo          , Wo          , Wo          , Wo          , Wo          
Gs^Fp       , Gs^Fp       , Gg          , 1 Ke        , Gg          , Gg          , Gg          , Gg          , Gs^Fp       , Gg          , Gg          , Gg          , Gg          , Gg          , Ds          , Ds          , Wwf         , Wwf         , Wwf         , Wwf         , Ww          , Ww          , Ww          , Ww          , Ww          , Ds          , Ww          , Ds          , Ww          , Ds          , Ww          , Ww          , Ww          , Ww          , Wo          , Wo          , Wo          , Wo          , Wo          , Wo          , Wo          , Wo          
Gs^Fp       , Gs^Fp       , Gs^Fp       , Gs^Fp       , Gs^Fp       , Gg          , Gs^Fp       , Gg^Ve       , Gs^Fp       , Gs^Fp       , Gs^Fp       , Gs^Fp       , Gg          , Ds          , Ww          , Ww          , Ww          , Ww          , Ww          , Ww          , Wo          , Wo          , Wo          , Ww          , Ww          , Ww          , Ww          , Ww          , Ww          , Ww          , Ww          , Ww          , Wo          , Wo          , Wo          , Wo          , Wo          , Wo          , Wo          , Wo          , Wo          , Wo          
Gs^Fp       , Gs^Fp       , Gs^Fp       , Gs^Fp       , Gs^Fp       , Gg          , Gs^Fp       , Gg          , Gs^Fp       , Gs^Fp       , Gs^Fp       , Gs^Fp       , Gg          , Ds          , Ww          , Ww          , Ww          , Ww          , Wo          , Wo          , Wo          , Wo          , Wo          , Wo          , Wo          , Ww          , Ww          , Ww          , Ww          , Ww          , Wo          , Wo          , Wo          , Wo          , Wo          , Wo          , Wo          , Wo          , Wo          , Wo          , Wo          , Wo          
