border_size=1
usage=map

Mm          ,Mm          , Hh          , Mm          , Hh          , Hh          , Gs^Fp       , Gs^Fp       , Gs^Fp       , Gs^Fp       , Mm          , Mm          , Hh          , Hh          , Hh          , Mm          , Gs^Fp       , Hh          , Hh          , Mm          , Hh          , Hh          , Hh          , Mm          , Mm          , Mm          , Mm          
Mm          ,Mm          , Hh          , Mm          , Hh          , Hh          , Gs^Fp       , Gs^Fp       , Gs^Fp       , Gs^Fp       , Mm          , Mm          , Hh          , Hh          , Hh          , Mm          , Gs^Fp       , Hh          , Hh          , Mm          , Hh          , Hh          , Hh          , Mm          , Mm          , Mm          , Mm          
Mm          ,Mm          , 1 Ke        , Hh          , Gs^Fp       , Gs^Fp       , Gs^Fp       , Gg^Ve       , Gs^Fp       , Hh          , Hh          , Hh          , Hh          , Gg          , Gs^Fp       , Gs^Fp       , Gs^Fp       , Gs^Fp       , Hh          , Hh          , Gg^Ve       , Gg          , Ce          , 2 Ke        , Hh          , Hh          , Hh          
Hh          ,Hh          , Ce          , Ce          , Gg          , Gs^Fp       , Gg          , Gs^Fp       , Gg          , Gg          , Gs^Fp       , Hh          , Gg          , Gg          , Hh          , Gs^Fp       , Gs^Fp       , Gs^Fp       , Gg          , Gs^Fp       , Gs^Fp       , Gg          , Ce          , Ce          , Gs^Fp       , Gs^Fp       , Gs^Fp       
Gs^Fp       ,Gs^Fp       , Gg          , Ce          , Gg          , Gg          , Hh          , Hh          , Hh          , Hh          , Hh          , Gs^Fp       , Gs^Fp       , Hh          , Hh          , Hh          , Hh          , Gg          , Gs^Fp       , Hh          , Gs^Fp       , Gg          , Gg          , Gg          , Gg          , Gs^Fp       , Gs^Fp       
Hh          ,Hh          , Gg^Ve       , Gg          , Gg          , Gg          , Gg          , Gg          , Gg          , Hh          , Gg          , Gs^Fp       , Gs^Fp       , Gg          , Gg          , Gg          , Gs^Fp       , Gs^Fp       , Gg          , Hh          , Hh          , Gs^Fp       , Gs^Fp       , Gg^Ve       , Hh          , Gs^Fp       , Gs^Fp       
Hh          ,Hh          , Gs^Fp       , Gs^Fp       , Gg          , Gg          , Gg          , Gs^Fp       , Gs^Fp       , Gs^Fp       , Gs^Fp       , Gg          , Gg          , Gg          , Gs^Fp       , Gg          , Gg          , Gs^Fp       , Gg          , Gg          , Gg          , Gs^Fp       , Gs^Fp       , Gs^Fp       , Hh          , Mm          , Mm          
Gs^Fp       ,Gs^Fp       , Gs^Fp       , Gs^Fp       , Gs^Fp       , Gs^Fp       , Gs^Fp       , Gg          , Gg          , Gg          , Gg          , Gg          , Gg          , Gg          , Gs^Fp       , Gs^Fp       , Gs^Fp       , Gg          , Gs^Fp       , Gg          , Gg          , Gs^Fp       , Hh          , Hh          , Hh          , Gs^Fp       , Gs^Fp       
Gg          ,Gg          , Gg          , Gg          , Gg          , Gg          , Gg          , Gs^Fp       , Gg          , Gs^Fp       , Gs^Fp       , Gs^Fp       , Gg          , Gg          , Gs^Fp       , Gs^Fp       , Gg^Ve       , Gs^Fp       , Gg          , Gs^Fp       , Gs^Fp       , Gg          , Hh          , Hh          , Ds          , Gg^Ve       , Gg       
Gg          ,Gg          , Gg^Ve       , Gg          , Gs^Fp       , Gg          , Gs^Fp       , Gg          , Gs^Fp       , Gs^Fp       , Gs^Fp       , Gg          , Gg^Ve       , Gg          , Gs^Fp       , Gs^Fp       , Gg          , Gg          , Hh          , Gs^Fp       , Ds          , Hh          , Ds          , Ds          , Ww          , Ds          , Ds          
Gs^Fp       ,Gs^Fp       , Ds          , Gs^Fp       , Ds          , Gs^Fp       , Gg          , Gg          , Ds          , Gs^Fp       , Ds          , Gs^Fp       , Ds          , Gs^Fp       , Ds          , Gs^Fp       , Ds          , Ds          , Ds          , Ds          , Ww          , Ds          , Ww          , Ww          , Wo          , Ww          , Ww          
Ds          ,Ds          , Ww          , Ds          , Ww          , Ds          , Ds          , Ds          , Ww          , Ds          , Ww          , Ds          , Ww          , Ds          , Ww^Bw|      , Ds          , Ww          , Ww          , Ww          , Ww          , Wo          , Ww^Bw|      , Wo          , Wo          , Ww          , Wo          , Wo          
Ww          ,Ww          , Wo          , Ww          , Wo          , Ww          , Ww^Bw|      , Ww          , Wo          , Ww          , Wo          , Ww          , Wo          , Ww          , Ww^Bw|      , Ww          , Wo          , Wo          , Wo          , Wo          , Ww          , Ww^Bw|      , Ww          , Ww          , Ds          , Ww          , Ww          
Wo          ,Wo          , Wo          , Wo          , Wo          , Wo          , Ww^Bw|      , Wo          , Wo          , Wo          , Wo          , Wo          , Ww          , Wo          , Ww^Bw|      , Wo          , Wo          , Wo          , Ww          , Ww          , Ds          , Ds          , Ds          , Ds          , Gg^Ve       , Ds          , Ds          
Wo          ,Wo          , Ww          , Wo          , Ww          , Ww          , Ds          , Ww          , Ww          , Ww          , Ww          , Ww          , Ds          , Ww          , Ds          , Ww          , Ww          , Ww          , Ds          , Ds          , Gg          , Gs^Fp       , Gs^Fp       , Gg          , Gg          , Gg          , Gg          
Ww          ,Ww          , Ds          , Ww          , Ds          , Ds          , Hh          , Ds          , Ds          , Ds          , Ds          , Ds          , Gs^Fp       , Ds          , Gg^Ve       , Ds          , Ds          , Ds          , Gg          , Gg          , Gg          , Hh          , Gg          , Gs^Fp       , Gs^Fp       , Gs^Fp       , Gs^Fp       
Ds          ,Ds          , Gg          , Ds          , Gg          , Gg^Ve       , Hh          , Gs^Fp       , Gs^Fp       , Gs^Fp       , Gg          , Gs^Fp       , Gs^Fp       , Gs^Fp       , Hh          , Gg          , Gs^Fp       , Gs^Fp       , Gs^Fp       , Gs^Fp       , Gg          , Hh          , Hh          , Hh          , Gs^Fp       , Gg          , Gg          
Gs^Fp       ,Gs^Fp       , Gg          , Hh          , Gs^Fp       , Gg          , Gs^Fp       , Gs^Fp       , Hh          , Hh          , Ce          , Gs^Fp       , Ce          , Hh          , Hh          , Gg          , Gs^Fp       , Hh          , Gg          , Gs^Fp       , Hh          , Gg          , Hh          , Gg^Ve       , Gs^Fp       , Gg          , Gg          
Gg          ,Gg          , Gg          , Hh          , Gs^Fp       , Gs^Fp       , Gs^Fp       , Gs^Fp       , Mm          , Gs^Fp       , Hh          , Ce          , Hh          , Mm          , Gs^Fp       , Gs^Fp       , Gs^Fp       , Gs^Fp       , Gg          , Gg          , Hh          , Hh          , Ds          , Ds          , Ds          , Ds          , Ds          
Gg          ,Gg          , Gg          , Gs^Fp       , Gs^Fp       , Hh          , Gg          , Hh          , Hh          , Mm          , Ce          , 3 Ke        , Ce          , Gs^Fp       , Gs^Fp       , Gs^Fp       , Gg^Ve       , Gg          , Hh          , Gg          , Ds          , Ds          , Ww          , Ww          , Ww          , Ww          , Ww          
Hh          ,Hh          , Hh          , Hh          , Mm          , Gs^Fp       , Gg^Ve       , Hh          , Mm          , Mm          , Re          , Re          , Re          , Mm          , Hh          , Gs^Fp       , Gs^Fp       , Gs^Fp       , Gs^Fp       , Hh          , Ds          , Ww          , Wo          , Wo          , Wo          , Wo          , Wo          
Hh          ,Hh          , Hh          , Hh          , Mm          , Gs^Fp       , Gg       , Hh          , Mm          , Mm          , Re          , Re          , Re          , Mm          , Hh          , Gs^Fp       , Gs^Fp       , Gs^Fp       , Gs^Fp       , Hh          , Ds          , Ww          , Wo          , Wo          , Wo          , Wo          , Wo          
