border_size=1
usage=map

Mm          ,Mm          , Mm^Xm       , Mm          , Mm          , Mm          , Mm          , Mm          , Hh          , Hh          , Mm          , Mm          , Hh          , Hh          , Gs^Fp       , Hh          , Gs^Fp       , Re          , Gs^Fp       , Hh          , Gs^Fp       , Hh          , Hh          , Mm          , Mm          , Mm          , Mm^Xm       , Mm^Xm       , Mm^Xm       , Mm^Xm       
Mm          ,Mm          , Mm^Xm       , Mm          , Mm          , Mm          , Mm          , Mm          , Hh          , Hh          , Mm          , Mm          , Hh          , Hh          , Gs^Fp       , Hh          , Gs^Fp       , Re          , Gs^Fp       , Hh          , Gs^Fp       , Hh          , Hh          , Mm          , Mm          , Mm          , Mm^Xm       , Mm^Xm       , Mm^Xm       , Mm^Xm       
Mm^Xm       ,Mm^Xm       , Mm^Xm       , Mm          , Hh          , Hh          , Hh          , Hh          , Hh          , Mm          , Hh          , Hh          , Hh          , Gs^Fp       , Gs^Fp       , Gs^Fp       , Gs^Fp       , Re          , Re          , Gs^Fp       , Gg^Ve       , Gs^Fp       , Gs^Fp       , Hh          , Hh          , Mm          , Mm          , Mm^Xm       , Mm^Xm       , Mm^Xm       
Mm^Xm       ,Mm^Xm       , Mm^Xm       , Mm          , Mm          , Mm          , Mm          , Mm          , Hh          , Hh          , Hh          , Gs^Fp       , Gs^Fp       , Gs^Fp       , Gg^Ve       , Gs^Fp       , Gs^Fp       , Gs^Fp       , Gs^Fp       , Re          , Gs^Fp       , Gs^Fp       , Gs^Fp       , Gs^Fp       , Hh          , Hh          , Hh          , Mm          , Mm          , Mm          
Mm^Xm       ,Mm^Xm       , Mm^Xm       , Mm          , Mm          , Mm          , Mm          , Hh          , Hh          , Hh          , Hh          , Gs^Fp       , Gs^Fp       , Gs^Fp       , Gs^Fp       , Gs^Fp       , Gg^Fet      , Gg^Fet      , Gg^Fet      , Re          , Gg^Fet      , Gg^Fet      , Gg^Fet      , Gs^Fp       , Gs^Fp       , Hh          , Hh          , Hh          , Mm          , Mm          
Mm^Xm       ,Mm^Xm       , Mm^Xm       , Mm          , Mm          , Mm          , Hh          , Hh          , Gg^Ve       , Hh          , Hh          , Hh          , Hh          , Gs^Fp       , Gs^Fp       , Gg^Fet      , Cv          , Cv          , 1 Kv        , Re          , 2 Kv        , Cv          , Cv          , Gg^Fet      , Gs^Fp       , Gg^Ve       , Hh          , Hh          , Mm          , Mm          
Mm^Xm       ,Mm^Xm       , Mm^Xm       , Mm          , Mm          , Hh          , Hh          , Gs^Fp       , Gs^Fp       , Hh          , Hh          , Hh          , Hh          , Hh          , Gs^Fp       , Gg^Fet      , Cv          , Gs^Fp       , Gs^Fp       , Re          , Gs^Fp       , Gs^Fp       , Cv          , Gg^Fet      , Hh          , Hh          , Hh          , Mm          , Mm^Xm       , Mm^Xm       
Mm^Xm       ,Mm^Xm       , Mm^Xm       , Mm          , Mm          , Hh          , Gs^Fp       , Gs^Fp       , Gg          , Gg^Efm         , Hh          , Hh          , Hh          , Gg^Ve       , Gs^Fp       , Gg^Fet      , Gg^Fet      , Cv          , Cv          , Gs^Fp       , Cv          , Cv          , Gg^Fet      , Gg^Fet      , Hh          , Hh          , Mm          , Mm          , Mm^Xm       , Mm^Xm       
Mm^Xm       ,Mm^Xm       , Mm          , Mm          , Mm          , Hh          , Gg          , Gg          , Gg          , Gg          , Gg          , Gg          , Gg          , Gg          , Gg          , Hh          , Hh          , Gg^Fet      , Gg^Fet      , Gs^Fp       , Gg^Fet      , Gg^Fet      , Hh          , Hh          , Hh          , Mm          , Mm          , Mm          , Mm^Xm       , Mm^Xm       
Mm^Xm       ,Mm^Xm       , Mm          , Mm          , Hh          , Hh          , Hh^Vhh      , Gg          , Gs^Fp       , Gg          , Gs^Fp       , Gs^Fp       , Gs^Fp       , Gg          , Gg          , Gg          , Gg^Efm         , Hh          , Hh          , Gg^Ve       , Gs^Fp       , Gs^Fp       , Gg^Efm         , Hh          , Hh          , Hh          , Hh          , Mm          , Mm          , Mm          
Mm^Xm       ,Mm^Xm       , Mm          , Hh          , Hh          , Hh          , Hh          , Hh          , Gs^Fp       , Gs^Fp       , Hh          , Gs^Fp       , Gs^Fp       , Gg^Vh       , Gg          , Gg          , Gs^Fp       , Gs^Fp       , Hh          , Hh          , Gs^Fp       , Gs^Fp       , Gg          , Gg          , Hh^Vhh      , Hh          , Hh          , Mm          , Mm          , Mm          
Mm          ,Mm          , Mm          , Hh          , Hh          , Hh          , Gs^Fp       , Gs^Fp       , Gs^Fp       , Gs^Fp       , Gg          , Gg          , Gg          , Hh          , Hh          , Gs^Fp       , Gs^Fp       , Gs^Fp       , Gs^Fp       , Gs^Fp       , Gg          , Hh          , Gg          , Gg          , Gg          , Hh          , Hh          , Hh          , Mm          , Mm          
Mm          ,Mm          , Mm          , Hh          , Hh          , Hh          , Gg^Efm         , Gs^Fp       , Cud         , Gg          , Gg          , Gg          , Hh          , Hh          , Gg          , Gg          , Gg          , Gg          , Gg          , Gg          , Gg          , Hh          , Gg          , Gg          , Gg          , Hh          , Hh          , Hh          , Mm          , Mm          
Mm          ,Mm          , Mm          , Hh          , Hh          , Gg          , Gg          , Cud         , 3 Kud       , Cud         , Cud         , Gg          , Hh          , Hh          , Hh          , Gg          , Hh          , Gg          , Gs^Fp       , Gs^Fp       , Gs^Fp       , Gs^Fp       , Gg          , Gg          , Hh          , Hh          , Mm          , Mm          , Mm^Xm       , Mm^Xm       
Mm          ,Mm          , Mm          , Hh          , Hh          , Gg          , Gs^Fp       , Gg          , Cud         , Cud         , Gs^Fp       , Gg          , Gg          , Hh          , Hh^Vhh      , Hh          , Gg          , Gg^Efm         , Hh          , Gs^Fp       , Gs^Fp       , Gs^Fp       , Gg          , Hh          , Hh          , Mm          , Mm          , Mm^Xm       , Mm^Xm       , Mm^Xm       
Mm          ,Mm          , Mm          , Mm          , Hh          , Gs^Fp       , Gs^Fp       , Gg          , Gg          , Gs^Fp       , Gs^Fp       , Gg          , Gs^Fp       , Gg          , Gs^Fp       , Gg          , Gg          , Gg          , Gg          , Hh          , Gg^Vh       , Gg          , Gg^Efm         , Hh          , Hh          , Mm          , Mm          , Mm          , Mm          , Mm          
Mm          ,Mm          , Mm          , Mm          , Hh          , Hh          , Hh          , Gg          , Hh^Vhh      , Gs^Fp       , Gg          , Gg          , Gs^Fp       , Gs^Fp       , Gs^Fp       , Gg          , Gg          , Gg          , Gg          , Gg          , Gg          , Gg          , Gs^Fp       , Gs^Fp       , Gs^Fp       , Hh          , Hh          , Mm          , Mm          , Mm          
Mm^Xm       ,Mm^Xm       , Mm^Xm       , Mm          , Mm          , Hh          , Hh          , Hh          , Hh          , Hh          , Hh          , Hh          , Gs^Fp       , Gs^Fp       , Gg          , Gg          , Hh          , Hh          , Hh          , Hh          , Gg          , Gg          , Gg          , Gs^Fp       , Gs^Fp       , Gs^Fp       , Mm          , Mm          , Mm^Xm       , Mm^Xm       
Mm^Xm       ,Mm^Xm       , Mm^Xm       , Mm          , Mm          , Mm^Vhh      , Hh          , Hh          , Gs^Fp       , Hh          , Hh          , Hh          , Gs^Fp       , Hh          , Hh          , Gg          , Hh          , Hh          , Hh          , Hh          , Hh          , Gg          , Gg          , Hh          , Hh          , Hh          , Hh          , Mm          , Mm^Xm       , Mm^Xm       
Mm^Xm       ,Mm^Xm       , Mm^Xm       , Mm          , Mm          , Mm          , Hh          , Gs^Fp       , Gs^Fp       , Hh          , Hh          , Hh          , Hh          , Hh          , Hh          , Hh^Vhh      , Gg          , Hh          , Gg          , Hh          , Gg          , Gg          , Hh          , Hh          , Mm          , Mm          , Mm          , Mm          , Mm^Xm       , Mm^Xm       
Mm^Xm       ,Mm^Xm       , Mm^Xm       , Mm          , Mm          , Mm          , Hh          , Hh          , Gg          , Gg          , Gg          , Gg          , Gg          , Hh          , Gg          , Hh          , Gg          , Gg          , Hh          , Hh          , Gg          , Gg^Efm         , Gg^Vh       , Hh          , Mm          , Mm          , Mm          , Mm          , Mm          , Mm          
Mm^Xm       ,Mm^Xm       , Mm^Xm       , Mm          , Mm          , Mm          , Hh          , Hh          , Gg          , Gg          , Gg          , Gg          , Hh          , Gg          , Gg          , Gg          , Hh          , Hh          , Mm          , Mm          , Gg          , Gg          , Gg          , Hh          , Hh          , Mm          , Hh          , Hh          , Mm          , Mm          
Mm^Xm       ,Mm^Xm       , Mm          , Mm          , Mm          , Hh          , Hh          , Gg          , Hh          , Gg^Vh       , Hh          , Hh          , Hh          , Hh          , Gs^Fp       , Gg^Efm         , Gs^Fp       , Hh^Vhh      , Gg          , Hh          , Gg          , Gg          , Gg          , Gs^Fp       , Gs^Fp       , Hh          , Hh          , Hh          , Mm          , Mm          
Mm^Xm       ,Mm^Xm       , Mm          , Mm          , Hh          , Hh          , Gg^Efm         , Gg          , Hh          , Hh          , Gg          , Hh          , Gg          , Gs^Fp       , Gs^Fp       , Gs^Fp       , Gg          , Gg          , Gg          , Hh          , Gs^Fp       , Hh          , Hh          , Gg^Efm         , Hh          , Hh          , Mm          , Mm          , Mm^Xm       , Mm^Xm       
Mm^Xm       ,Mm^Xm       , Mm          , Hh          , Hh          , Hh          , Gs^Fp       , Gs^Fp       , Gs^Fp       , Gg          , Gg          , Gg          , Gg          , Gg          , Gg          , Gg          , Cud         , Gg          , Gg          , Gg          , Gg          , Gs^Fp       , Gs^Fp       , Hh          , Hh          , Hh          , Hh          , Mm          , Mm          , Mm          
Xu          ,Xu          , Xu          , Xu          , Uu          , Gg          , Gg          , Gs^Fp       , Gs^Fp       , Gg          , Gg^Vh       , Gg          , Gg          , Hh          , Hh          , Cud         , 4 Kud       , Cud         , Gg          , Gg          , Gg^Vh       , Gs^Fp       , Hh          , Hh          , Mm          , Hh          , Mm          , Hh          , Mm          , Mm          
Uu          ,Uu          , Uu          , Uu          , Gg          , Gg          , Gg          , Gg          , Hh          , Hh          , Hh          , Hh          , Hh          , Hh          , Hh          , Cud         , Cud         , Cud         , Gs^Fp       , Gg          , Gg^Efm         , Gs^Fp       , Hh          , Hh          , Mm          , Mm          , Mm          , Mm          , Mm          , Mm          
Uu          ,Uu          , Uu          , Uu          , Uu          , Gg          , Hh          , Hh          , Hh          , Hh          , Hh          , Hh          , Hh          , Hh          , Hh          , Hh          , Hh          , Gs^Fp       , Gs^Fp       , Gg          , Hh          , Hh          , Hh          , Mm          , Mm          , Mm          , Mm          , Mm          , Mm^Xm       , Mm^Xm       
Uu          ,Uu          , Xu          , Xu          , Xu          , Uu          , Mm          , Hh          , Mm          , Mm          , Mm          , Mm          , Mm          , Mm^Vhh      , Mm          , Hh          , Hh          , Hh          , Hh          , Gs^Fp       , Hh          , Mm          , Mm          , Mm          , Mm          , Mm          , Mm          , Mm          , Mm^Xm       , Mm^Xm       
Xu          ,Xu          , Mm          , Mm          , Mm          , Mm          , Mm          , Mm          , Mm          , Mm          , Mm          , Mm          , Mm          , Mm          , Mm          , Mm          , Mm          , Mm          , Mm          , Hh          , Mm          , Mm          , Mm          , Mm          , Mm          , Mm          , Mm          , Mm^Xm       , Mm^Xm       , Mm^Xm       
Mm          ,Mm          , Mm          , Mm          , Mm          , Mm          , Mm          , Mm          , Mm          , Mm          , Mm          , Mm          , Mm          , Mm          , Mm          , Mm          , Mm          , Mm          , Mm          , Mm          , Mm          , Mm          , Mm^Xm       , Mm          , Mm^Xm       , Mm^Xm       , Mm^Xm       , Mm^Xm       , Mm^Xm       , Mm^Xm       
Mm          ,Mm          , Mm          , Mm          , Mm          , Mm          , Mm          , Mm          , Mm          , Mm          , Mm          , Mm          , Mm          , Mm          , Mm          , Mm          , Mm          , Mm          , Mm          , Mm          , Mm          , Mm          , Mm^Xm       , Mm          , Mm^Xm       , Mm^Xm       , Mm^Xm       , Mm^Xm       , Mm^Xm       , Mm^Xm       
