border_size=1
usage=map

Gs^Fp       , Gs^Fp       , Gs^Fp       , Gs^Fp       , Gs^Fp       , Gs^Fp       , Gg          , Gg          , Gg          , Gg          , Gs^Fp       , Gg          , Gs^Fp       , Gg          , Gs^Fp       , Gg          , Gg          , Gs^Fp       , Gs^Fp       , Gs^Fp       , Gg          , Gg          , Gs^Fp       , Gg          , Gg          , Gg          , Gg          , Gg          , Gg          , Gg          , Gs^Fp       , Gg          , Gs^Fp       , Gg          , Gs^Fp       , Gs^Fp       , Gs^Fp       , Gg          , Gg          , Gg          , Gg          , Gg          
Gs^Fp       , Gs^Fp       , Gs^Fp       , Gs^Fp       , Gs^Fp       , Gs^Fp       , Gg          , Gg          , Gg          , Gg          , Gs^Fp       , Gg          , Gs^Fp       , Gg          , Gs^Fp       , Gg          , Gg          , Gs^Fp       , Gs^Fp       , Gs^Fp       , Gg          , Gg          , Gs^Fp       , Gg          , Gg          , Gg          , Gg          , Gg          , Gg          , Gg          , Gs^Fp       , Gg          , Gs^Fp       , Gg          , Gs^Fp       , Gs^Fp       , Gs^Fp       , Gg^Ve       , Gg          , Gg          , Gg          , Gg          
Gs^Fp       , Gs^Fp       , Gg^Ve       , Gs^Fp       , Gs^Fp       , Gs^Fp       , Gs^Fp       , Gg          , Ce          , 1 Ke        , Gg          , Gs^Fp       , Gg^Ve       , Gs^Fp       , Gs^Fp       , Gg          , Gg          , Gs^Fp       , Gs^Fp       , Gg          , Gs^Fp       , Gg          , Gs^Fp       , Gg^Ve       , Gg          , Gg          , Gs^Fp       , Gg          , Gs^Fp       , Gs^Fp       , Gg          , Gs^Fp       , Gs^Fp       , Gs^Fp       , Gg          , Gg          , Gg          , Gs^Fp       , 2 Ke        , Gg          , Gg          , Gg          
Gg          , Gg          , Gs^Fp       , Gs^Fp       , Gg          , Gg          , Gg          , Ce          , Ce          , Ce          , Gg          , Gg          , Gs^Fp       , Gg          , Gs^Fp       , Gs^Fp       , Gg          , Gg          , Gg          , Gs^Fp       , Gg          , Gg          , Gg          , Gs^Fp       , Gg          , Gs^Fp       , Gg          , Gs^Fp       , Gs^Fp       , Gg          , Gg          , Gs^Fp       , Gg          , Gg          , Gg          , Gs^Fp       , Ce          , Ce          , Ce          , Gs^Fp       , Gg          , Gg          
Gs^Fp       , Gs^Fp       , Gg          , Gg          , Gg          , Gg          , Gs^Fp       , Gg          , Gs^Fp       , Ce          , Gg          , Gg          , Gs^Fp       , Gg          , Gg          , Gg          , Gg          , Gg          , Gg          , Gg          , Gs^Fp       , Gg          , Gg          , Gg          , Gs^Fp       , Gg          , Gs^Fp       , Gs^Fp       , Gg          , Gg          , Gg          , Gg          , Gg          , Gg          , Gg          , Gg          , Gg          , Ce          , Ce          , Gg          , Gg          , Gg          
Ds          , Ds          , Ds          , Gg          , Ds          , Gs^Fp       , Gg          , Gs^Fp       , Gg          , Gs^Fp       , Gs^Fp       , Gg          , Gg          , Gs^Fp       , Gs^Fp       , Gg^Ve       , Gg          , Gg          , 3 Ke        , Gs^Fp       , Gg          , Gs^Fp       , Gs^Fp       , Gs^Fp       , Gg          , Gg          , Gs^Fp       , Gs^Fp       , Gg          , Gs^Fp       , Gs^Fp       , Gg          , Gg^Ve       , Gg          , Gs^Fp       , Gs^Fp       , Gg          , Gs^Fp       , Gg          , Gg          , Gg          , Gg          
Ww          , Ww          , Ww^Bw|      , Ds          , Ww          , Ds          , Ds          , Gg^Ve       , Gg          , Gg          , Gg          , Gs^Fp       , Gg          , Gg          , Gg          , Gg          , Gg          , Gs^Fp       , Ce          , Ce          , Ce          , Gs^Fp       , Gg          , Gg          , Gs^Fp       , Gs^Fp       , Gg          , Gg          , Gg^Ve       , Gg          , Gg          , Gs^Fp       , Gs^Fp       , Gs^Fp       , Gs^Fp       , Gg          , Gg          , Gg          , Gs^Fp       , Gs^Fp       , Gs^Fp       , Gs^Fp       
Wo          , Wo          , Ww^Bw|      , Ww          , Wo          , Ww          , Ds          , Gg          , Gg          , Gs^Fp       , Gs^Fp       , Gs^Fp       , Gs^Fp       , Gs^Fp       , Gs^Fp       , Gg          , Gg          , Gs^Fp       , Ce          , Ce          , Gs^Fp       , Gg          , Gg          , Gg          , Gg          , Gs^Fp       , Gs^Fp       , Gs^Fp       , Gg          , Gg          , Gg          , Gs^Fp       , Gs^Fp       , Gs^Fp       , Gs^Fp       , Gg          , Gg          , Gg          , Gg          , Gg^Ve       , Gs^Fp       , Gs^Fp       
Ww          , Ww          , Ww^Bw|      , Wo          , Wo          , Ww          , Ww          , Ds          , Ds          , Gg          , Gg          , Gg          , Gg          , Gg          , Gs^Fp       , Gg          , Gs^Fp       , Gg          , Gg          , Gg          , Gs^Fp       , Gs^Fp       , Gg          , Gg          , Gg          , Gg          , Gg          , Gg          , Gg          , Gg          , Gg          , Gg          , Gg          , Gg          , Gg          , Gs^Fp       , Gg          , Gg          , Ds          , Gg          , Ds          , Ds          
Ds          , Ds          , Ds          , Ww          , Wo          , Wo          , Wo          , Ww          , Ds          , Gg          , Gg          , Gs^Fp       , Gg          , Gs^Fp       , Gg^Ve       , Gs^Fp       , Gg          , Gs^Fp       , Gg          , Gs^Fp       , Gg          , Gg          , Gg          , Gg          , Ds          , Gg^Ve       , Ds          , Gg          , Ds          , Gg          , Ds          , Gg          , Ds          , Gg          , Ds          , Ds          , Ds          , Ds          , Ww          , Ds          , Ww          , Ww          
Gg          , Gg          , Ds          , Ww          , Ww          , Wo          , Wo          , Ww          , Ds          , Gg^Ve       , Ds          , Gs^Fp       , Gs^Fp       , Gs^Fp       , Gs^Fp       , Gg          , Gg          , Gg          , Gg          , Gg          , Gg          , Gg          , Ds          , Ds          , Ww          , Ds          , Ww          , Ds          , Ww          , Ds          , Ww          , Ds          , Ww          , Ds          , Ww          , Ww          , Ww          , Ww          , Wo          , Ww          , Ww          , Ww          
Gg          , Gg          , Gg          , Ds          , Ds          , Ww          , Wo          , Ww          , Ww^Bw|      , Ds          , Ww          , Ds          , Ds          , Gg          , Gg          , Gg          , Ds          , Ds          , Ds          , Ds          , Ds          , Ds          , Ww          , Ww          , Wo          , Ww          , Wo          , Ww          , Wo          , Ww          , Wo          , Ww          , Wo          , Ww^Bw|      , Wo          , Wo          , Wo          , Wo          , Wo          , Wo          , Wo          , Wo          
Gg          , Gg^Ve       , Gs^Fp       , Gg          , Ds          , Ww          , Ww          , Wo          , Ww^Bw|      , Ww          , Wo          , Ww          , Ww          , Ds          , Ds          , Ds          , Ww          , Ww          , Ww          , Ww          , Ww          , Ww^Bw|      , Ww          , Wo          , Ww          , Wo          , Ww          , Wo          , Ww          , Wo          , Ww          , Wo          , Ww          , Ww^Bw|      , Ww          , Wo          , Ww          , Wo          , Wo          , Wo          , Wo          , Wo          
Gs^Fp       , Gs^Fp       , Gs^Fp       , Gg          , Gg          , Ds          , Ds          , Ww          , Ds          , Ww          , Ww          , Wo          , Wo          , Ww          , Ww          , Ww          , Wo          , Wo          , Wo          , Wo          , Ww          , Ww^Bw|      , Ww          , Ww          , Ds          , Ww          , Ds          , Ww          , Ds          , Ds          , Ds          , Ww          , Ds          , Ds          , Ds          , Ww          , Ds          , Ww          , Ww          , Wo          , Wo          , Wo          
Gs^Fp       , Gs^Fp       , Gs^Fp       , Gs^Fp       , Hh          , Gg          , Gg          , Ds          , Hh          , Ds          , Ds          , Ww          , Wo          , Wo          , Wo          , Wo          , Wo          , Wo          , Ww          , Ww          , Ds          , Ds          , Ds          , Ds          , Gg^Ve       , Ds          , Hh          , Ds          , Gs^Fp       , Gg          , Gs^Fp       , Ds          , Gg          , Gg          , Gg          , Ds          , Hh          , Ds          , Ww          , Ww          , Wo          , Wo          
Gs^Fp       , Gs^Fp       , Gg          , Hh          , Gg          , Hh          , Gs^Fp       , Gg          , Gg          , Gs^Fp       , Ds          , Ww          , Ww          , Wo          , Wo          , Wo          , Ww          , Ww          , Ds          , Ds          , Gg          , Gg          , Gs^Fp       , Gg          , Gs^Fp       , Gg          , Ke          , Gs^Fp       , Gs^Fp       , Gs^Fp       , Gs^Fp       , Gg^Ve       , Gg          , Gs^Fp       , Gs^Fp       , Gs^Fp       , Hh          , Ds          , Ds          , Ww          , Wo          , Wo          
Hh          , Hh          , Ds          , Gg^Ve       , Ds          , Gg          , Gs^Fp       , Gs^Fp       , Gs^Fp       , Gs^Fp       , Gs^Fp       , Ds          , Ds          , Ww          , Wo          , Wo          , Ww          , Ds          , Gg^Ve       , Gg          , Gs^Fp       , Gs^Fp       , Hh          , Gs^Fp       , Gs^Fp       , Gg          , Ce          , Ce          , Ds          , Gs^Fp       , Gg          , Gs^Fp       , Gg          , Gg          , Hh          , Gs^Fp       , Gs^Fp       , Hh          , Ds          , Ww          , Wo          , Wo          
Ds          , Ds          , Ww^Bw|      , Ds          , Ww          , Ds          , Ds          , Ds          , Ds          , Ds          , Ds          , Gg^Ve       , Ds          , Ww          , Wo          , Wo          , Ww          , Ds          , Gg          , Gg          , Gs^Fp       , Hh          , Ds          , Hh          , Ds          , Ds          , Ds          , Ds          , Ww          , Ds          , Ds          , Gg          , Ds          , Gg          , Ds          , Gg^Ve       , Ds          , Ds          , Ww          , Ww          , Wo          , Wo          
Ww          , Ww          , Ww^Bw|      , Ww          , Ww          , Ww          , Ww          , Ww          , Ww^Bw|      , Ww          , Ww          , Ds          , Ww          , Ww^Bw\      , Ww^Bw\      , Ww          , Ds          , Ds          , Gs^Fp       , Gg          , Ds          , Ds          , Ww          , Ds          , Ww^Bw|      , Ww          , Ww          , Ww          , Ww          , Ww          , Ww          , Ds          , Ww          , Ds          , Ww          , Ds          , Ww^Bw\      , Ww          , Wo          , Wo          , Ww          , Ww          
Wo          , Wo          , Ww^Bw|      , Wo          , Wo          , Wo          , Wo          , Wo          , Ww^Bw|      , Wo          , Wo          , Ww          , Wo          , Ww          , Ww          , Ds          , Hh          , Hh          , Gg^Ve       , Ds          , Ww          , Ww          , Ww          , Ww          , Ww^Bw|      , Ww          , Ww          , Ww          , Ds          , Ww          , Ww          , Ww^Bw|      , Ww          , Ww          , Wo          , Ww          , Wo          , Ww^Bw\      , Ww^Bw\      , Ww          , Ds          , Ds          
Ww          , Ww          , Ds          , Ww          , Ww          , Ww          , Ww          , Ww          , Ds          , Ww          , Ww          , Wo          , Wo          , Wo          , Ww          , Ds          , Ds          , Ds          , Ds          , Ds          , Ww          , Ww          , Ww          , Ww          , Ds          , Ww          , Ds          , Ds          , Gg          , Ds          , Ds          , Ds          , Ds          , Ww          , Ww          , Wo          , Ww          , Ww          , Ds          , Ds          , Gg          , Gg          
Ds          , Ds          , Gg          , Ds          , Ds          , Ds          , Ds          , Ds          , Gg          , Ds          , Ww          , Ww          , Ww          , Wo          , Ww          , Ww          , Ww          , Ww          , Ww          , Ww^Bw\      , Ww^Bw\      , Ww          , Ds          , Ds          , Gg          , Ds          , Gg          , Gg          , Gs^Fp       , Gs^Fp       , Gg          , Gg^Ve       , Ds          , Ww          , Ww          , Ww          , Ds          , Ds          , Gg          , Gs^Fp       , Gs^Fp       , Gs^Fp       
Gg          , Gg          , Gg          , Gg          , Gs^Fp       , Gg          , Gs^Fp       , Gg          , Gg          , Ds          , Ds          , Ds          , Ds          , Ww          , Ds          , Ww          , Ww          , Ww          , Ww          , Ww          , Ds          , Ds          , Gg          , Gg          , Gs^Fp       , Gg          , Ch          , Ch          , Ch          , Hh          , Hh          , Gs^Fp       , Ds          , Ww          , Ww          , Ds          , Gg          , Gs^Fp       , Gs^Fp       , Gg^Ve       , Gs^Fp       , Gs^Fp       
Gg          , Gg          , Gg^Ve       , Gs^Fp       , Ke          , Gs^Fp       , Hh          , Gs^Fp       , Gs^Fp       , Gg          , Gg          , Gg^Ve       , Gg          , Ds          , Gg          , Ds          , Ww          , Ww          , Ww          , Ds          , Gg          , Gs^Fp       , Gs^Fp       , Gs^Fp       , Ch          , Ch          , Rr          , Gg^Ve       , Hh          , Ch          , Ds          , Ds          , Ww          , Ww          , Ww          , Ds          , Ds          , Gg          , Gs^Fp       , Gs^Fp       , Gg          , Gg          
Gg          , Gg          , Gg          , Gg          , Ce          , Ce          , Hh          , Gg          , Gs^Fp       , Gg          , Gs^Fp       , Gg          , Gg          , Gg          , Gg          , Ds          , Ds          , Ww          , Ds          , Ds          , Gg          , Gg^Ve       , Gg          , Ch          , Gs^Fp       , 8 Kh        , Rr          , Gs^Fp       , Ds          , Ds          , Ww          , Ww          , Wo          , Wo          , Ww          , Ww          , Ds          , Gg          , Gg          , Gg          , Gs^Fp       , Gs^Fp       
Gg          , Gg          , Gs^Fp       , Gs^Fp       , Gs^Fp       , Gs^Fp       , Gg          , Gg          , Gg          , Gs^Fp       , Gg          , Gg          , Gs^Fp       , Gg          , Gs^Fp       , Gg          , Gg          , Ds          , Gg          , Gg          , Gs^Fp       , Gg          , Ch          , Ch          , Rr          , Rr          , Gs^Fp       , Gs^Fp       , Ds          , Ww          , Wo          , Wo          , Ww          , Wo          , Ww          , Ww          , Ds          , Gg          , Gg          , Gs^Fp       , Gs^Fp       , Gs^Fp       
Gs^Fp       , Gs^Fp       , Gs^Fp       , Gg          , Gg          , Gg          , Ch          , Gg          , Ch          , Gg          , Gg          , Gg          , Gs^Fp       , Gs^Fp       , Gg          , Gs^Fp       , Gg          , Gg          , Gs^Fp       , Gs^Fp       , Gs^Fp       , Gs^Fp       , Ch          , Gg^Ve       , Rr          , Gs^Fp       , Ds          , Ds          , Ww          , Ww          , Ww          , Ww          , Ds          , Ww          , Ds          , Ds          , Gg          , Gg          , Gg          , Gs^Fp       , Gg          , Gg          
Gs^Fp       , Gs^Fp       , Gg          , Gg          , Ch          , Ch          , Gg^Ve       , Ch          , Rr          , Ch          , Ch          , Gg          , Gg          , Gg^Ve       , Gg          , Gg          , Gs^Fp       , Gs^Fp       , Gs^Fp       , Gs^Fp       , Gg          , Gg          , Gg          , Rr          , Dd^Vda      , Ds          , Ww          , Ww          , Ww          , Ww          , Ds          , Ds          , Gg          , Ds          , Gg          , Gg          , Gg^Ve       , Gg          , Gs^Fp       , Gs^Fp       , Gg          , Gg          
Gs^Fp       , Gs^Fp       , Gg          , Gg          , Rr          , Rr          , Rr          , Rr          , Hh          , Rr          , 6 Kh        , Ch          , Gg          , Gg          , Gs^Fp       , Gs^Fp       , Gg          , Gg          , Gg          , Gs^Fp       , Gg          , Gg          , Gg          , Rr          , Ds          , Ds          , Ww^Bw\      , Ww          , Ds          , Ds          , Rr          , Ch          , Gg          , Gs^Fp       , Gs^Fp       , Gs^Fp       , Gs^Fp       , Gs^Fp       , Gg          , Gg          , Gg          , Gg          
Gs^Fp       , Gs^Fp       , Gg          , Rr          , Gs^Fp       , Gs^Fp       , Rr          , Hh          , Gs^Fp       , Rr          , Rr          , Ch          , Gg          , Gg          , Gs^Fp       , Gs^Fp       , Gg          , Gg          , Ch          , Gg          , Ch          , Gg          , Gg          , Rr          , Ds          , Ww          , Wo          , Ww^Bw\      , Ds          , Dd^Vda      , Rr          , Ch          , Gg          , Gs^Fp       , Gg          , Gg          , Gg          , Gs^Fp       , Gg          , Gg          , Gg          , Gg          
Gs^Fp       , Gs^Fp       , Ch          , Rr          , Rr          , Gs^Fp       , Gg^Ve       , Hh          , Ds          , Hh          , Rr          , Ch          , Gg          , Gg          , Gs^Fp       , Gs^Fp       , Gg          , Ch          , Gg^Ve       , Ch          , Rr          , Ch          , Gg^Ve       , Rr          , Ds          , Ww          , Wo          , Ww          , Ww          , Ds          , Rr          , Ch          , Ch          , Gg^Ve       , Ch          , Gg          , Gg          , Gg          , Gg          , Gs^Fp       , Gs^Fp       , Gs^Fp       
Gs^Fp       , Gs^Fp       , Ch          , Gg^Ve       , Rr          , Hh          , Ds          , Ds          , Ww          , Ds          , Rr          , Ch          , Gg          , Gg          , Gg          , Gg          , Gg          , Ch          , Rr          , Rr          , Gg^Ve       , Rr          , Rr          , Rr          , Ds          , Ww          , Wo          , Ww          , Ww          , Ds          , Ds          , Rr          , Rr          , Ch          , Gg^Ve       , Ch          , Ch          , Ch          , Ch          , Gg          , Gs^Fp       , Gs^Fp       
Gs^Fp       , Gs^Fp       , Gs^Fp       , Ch          , Rr          , Ds          , Ww          , Ww          , Ww          , Ds          , Rr          , Gg^Ve       , Gg          , Gg          , Gg^Ve       , Gg          , Ch          , 7 Kh        , Rr          , Gs^Fp       , Hh          , Gs^Fp       , Rr          , Gs^Fp       , Ds          , Ww          , Ww          , Wo          , Wo          , Ww          , Ww          , Ds          , Ds          , Rr          , Rr          , Rr          , Rr          , 9 Kh        , Ch          , Gg          , Gs^Fp       , Gs^Fp       
Gs^Fp       , Gs^Fp       , Gs^Fp       , Ch          , Rr          , Ds          , Ww          , Wo          , Ww          , Ds          , Ds          , Rr          , Rr          , Ch          , Ch          , Gg          , Ch          , Gg^Ve       , Rr          , Hh          , Hh          , Gs^Fp       , Rr          , Gs^Fp       , Ds          , Ww          , Ww          , Ww          , Ww          , Wo          , Ww          , Ww          , Ww^Bw/      , Rr          , Hh          , Hh          , Hh          , Rr          , Ch          , Gg^Ve       , Gg          , Gg          
Gs^Fp       , Gs^Fp       , Ch          , Ch          , Rr          , Ds          , Ww          , Wo          , Wo          , Ww          , Ww          , Ds          , Ds          , Rr          , Rr          , Ch          , Rr          , Rr          , Gs^Fp       , Gs^Fp       , Mm          , Hh          , Rr          , Gs^Fp       , Gs^Fp       , Ds          , Ww          , Ww          , Ds          , Ww          , Ww^Bw/      , Ww^Bw/      , Ww          , Ds          , Gs^Fp       , Gs^Fp       , Gs^Fp       , Rr          , Ch          , Gg          , Gg          , Gg          
Gs^Fp       , Gs^Fp       , Ch          , Gg^Ve       , Rr          , Rr          , Ww^Bw\      , Wo          , Wo          , Wo          , Wo          , Ww          , Ww          , Ds          , Gs^Fp       , Rr          , Rr          , Gs^Fp       , Rr          , Hh          , Rr          , Gg^Ve       , Rr          , Hh          , Gs^Fp       , Ds          , Ds          , Ds          , Rr          , Ww^Bw/      , Ww          , Ww          , Ww          , Ds          , Ch          , Gs^Fp       , Gs^Fp       , Rr          , Gg^Ve       , Ch          , Gg          , Gg          
Gs^Fp       , Gs^Fp       , Gs^Fp       , Ch          , 5 Kh        , Ds          , Ww          , Ww^Bw\      , Ww^Bw\      , Wo          , Ww          , Wo          , Ww          , Ds          , Gs^Fp       , Gg^Ve       , Rr          , Rr          , Hh          , Rr          , Hh          , Rr          , Rr          , Hh          , Rr          , Gs^Fp       , Rr          , Rr          , Hh          , Ds          , Ds          , Ww          , Ww          , Ds          , Gs^Fp       , Ch          , Ch          , Hh          , Hh          , Ch          , Gg          , Gg          
Gs^Fp       , Gs^Fp       , Gs^Fp       , Ch          , Ch          , Ds          , Ww          , Ww          , Wo          , Ww^Bw\      , Rr          , Ds          , Ds          , Ds          , Rr          , Rr          , Rr          , Hh          , Mm          , Mm          , Gs^Fp       , Hh          , Rr          , Rr          , Ch          , Rr          , Ch          , Gg^Ve       , Ch          , Ch          , Ds          , Ww          , Ww          , Ds          , Gs^Fp       , Gs^Fp       , Gs^Fp       , Ch          , Ch          , Ch          , Gs^Fp       , Gs^Fp       
Gg          , Gg^Ve       , Ds          , Ds          , Ds          , Ds          , Wo          , Wo          , Ds          , Ds          , Gg^Ve       , Rr          , Rr          , Rr          , Gs^Fp       , Gs^Fp       , Ch          , Rr          , Rr          , Rr          , Rr          , Rr          , Gg^Ve       , Ch          , Gs^Fp       , Ch          , Gs^Fp       , Ch          , Gs^Fp       , Ds          , Ww          , Ww          , Ww          , Ds          , Ds          , Gg^Ve       , Gs^Fp       , Gs^Fp       , Gs^Fp       , Gs^Fp       , Gs^Fp       , Gs^Fp       
Ds          , Ds          , Ww          , Ww          , Ww          , Wo          , Ww          , Ww          , Ds          , Ch          , Ch          , Ch          , Ch          , 4 Kh        , Ch          , Ch          , Gs^Fp       , Ch          , Ch          , Gg^Ve       , Ch          , Gs^Fp       , Ch          , Ch          , Gs^Fp       , Gs^Fp       , Gg^Ve       , Gs^Fp       , Ds          , Ds          , Ww          , Wo          , Wo          , Ww          , Ww          , Ds          , Ds          , Ds          , Ds          , Ds          , Ds          , Ds          
Ww          , Ww          , Wo          , Wo          , Wo          , Wo          , Ww          , Ds          , Gs^Fp       , Gs^Fp       , Gs^Fp       , Gs^Fp       , Gs^Fp       , Ch          , Gs^Fp       , Gs^Fp       , Gs^Fp       , Gs^Fp       , Gs^Fp       , Ch          , Gs^Fp       , Ch          , Gs^Fp       , Gs^Fp       , Gs^Fp       , Gs^Fp       , Gs^Fp       , Gs^Fp       , Ds          , Ww          , Wo          , Wo          , Wo          , Wo          , Wo          , Ww          , Ww          , Ww          , Ww          , Ww          , Ww          , Ww          
Ww          , Ww          , Wo          , Wo          , Wo          , Wo          , Ww          , Ds          , Gs^Fp       , Gs^Fp       , Gs^Fp       , Gs^Fp       , Gs^Fp       , Gs^Fp       , Gs^Fp       , Gs^Fp       , Gs^Fp       , Gs^Fp       , Gs^Fp       , Gs^Fp       , Gs^Fp       , Gs^Fp       , Gs^Fp       , Gs^Fp       , Gs^Fp       , Gs^Fp       , Gs^Fp       , Gs^Fp       , Ds          , Ww          , Wo          , Wo          , Wo          , Wo          , Wo          , Ww          , Ww          , Ww          , Ww          , Ww          , Ww          , Ww          
