border_size=1
usage=map

Mm          ,Mm          , Ce        , Mm          , Mm          , Mm          , Mm          , Mm          , Mm          , Mm          , Mm          , Mm          , Mm          , Mm          , Mm          , Mm          , Mm          , Mm          , Mm          , Mm          , Mm          , Mm          , Mm          , Mm          , Mm          , Mm          , Mm          , Mm          , Mm          , Mm          , Mm          , Mm          
Mm          ,Mm          , 7 Ke        , Mm          , Mm          , Mm          , Mm          , Mm          , Mm          , Mm          , Mm          , Mm          , Mm          , Mm          , Mm          , Mm          , Mm          , Mm          , Mm          , Mm          , Mm          , Mm          , Mm          , Mm          , Mm          , Mm          , Mm          , Mm          , Mm          , Mm          , Mm          , Mm          
Mm          ,Mm          , Ce          , Ce          , Mm          , Mm          , Mm          , Mm          , Mm          , Mm          , Mm          , Mm          , Hh          , Mm          , Hh          , Mm          , Mm          , Mm          , Mm          , Mm          , Mm          , Mm          , Hh          , Mm          , Mm          , Mm          , Mm          , Mm          , Ce          , 6 Ke        , Mm          , Mm          
Mm          ,Mm          , Mm          , Ce          , Mm          , Mm          , Mm          , Mm          , Mm          , Mm          , Mm          , Mm          , Hh          , Hh          , Hh          , Hh          , Hh          , Mm          , Mm          , Mm          , Hh          , Hh          , Hh          , Hh          , Hh          , Mm          , Mm          , Mm          , Ce          , Ce          , Mm          , Mm          
Mm          ,Mm          , Mm          , Mm          , Mm          , Mm          , Mm          , Mm          , Hh          , Mm          , Mm          , Hh          , Mm          , Mm          , Mm          , Mm          , Hh          , Hh          , Hh          , Mm          , Hh          , Mm          , Hh          , Hh          , Hh          , Hh          , Mm          , Mm          , Mm          , Mm          , Mm          , Mm          
Mm          ,Mm          , Mm          , Mm          , Mm          , Mm          , Hh          , Hh          , Hh          , Hh          , Hh          , Mm          , Mm          , Mm          , Hh          , Mm          , Mm          , Hh          , Mm          , Mm          , Mm          , Hh          , Mm          , Hh          , Mm          , Mm          , Mm          , Mm          , Mm          , Mm          , Mm          , Mm          
Mm          ,Mm          , Mm          , Mm          , Mm          , Hh          , Hh          , Hh          , Mm          , Mm          , Hh          , Mm          , Mm          , Mm          , Mm          , Hh          , Hh          , Hh          , Hh          , Hh          , Hh          , Mm          , Mm          , Hh          , Hh          , Hh          , Hh          , Mm          , Mm          , Mm          , Mm          , Mm          
Mm          ,Mm          , Mm          , Mm          , Mm          , Hh          , Hh          , Hh          , Mm          , Hh          , Hh          , Hh          , Hh          , Mm          , Hh          , Hh          , Hh          , Hh          , Hh^Vhh      , Hh          , Hh          , Hh          , Hh          , Hh          , Mm          , Hh          , Hh          , Hh          , Mm          , Mm          , Mm          , Mm          
Mm          ,Mm          , Mm          , Mm          , Mm          , Hh          , Hh          , Hh          , Hh          , Hh          , Hh          , Hh          , Cud         , Mm^Vhh      , Cud         , Hh          , Cud         , Cud         , Cud         , Cud         , Cud         , Cud         , Hh^Vhh      , Hh          , Hh          , Hh          , Hh          , Hh          , Mm          , Mm          , Mm          , Mm          
Mm          ,Mm          , Mm          , Mm          , Mm          , Mm          , Mm          , Mm          , Hh          , Hh          , Cud         , Cud         , Cud         , Cud         , Cud         , Cud         , Cud         , Cud         , Cud         , Cud         , Cud         , Cud         , Cud         , Hh          , Hh          , Hh          , Hh          , Hh          , Mm          , Mm          , Mm          , Mm          
Mm          ,Mm          , Mm          , Mm          , Mm          , Mm          , Mm          , Hh          , Hh          , Cud         , Cud         , Cud         , Gs^Vht      , Cud         , Rr          , Cud         , Rr          , Gs^Vht      , Rr          , Gs^Fp       , Gs^Fp       , Cud         , 1 Kud       , Cud         , Cud         , Hh          , Mm          , Mm          , Mm          , Mm          , Mm          , Mm          
Mm          ,Mm          , Mm          , Mm          , Hh          , Mm          , Mm^Vhh      , Hh          , Cud         , Cud         , 2 Kud       , Rr          , Rr          , Rr          , Hh          , Rr          , Hh          , Rr          , Hh          , Rr          , Rr          , Hh          , Rr          , Cud         , Cud         , Cud         , Mm^Vhh      , Mm          , Mm          , Mm          , Mm          , Mm          
Mm          ,Mm          , Hh          , Hh          , Hh^Vhh      , Cud         , Cud         , Cud         , Cud         , Cud         , Rr          , Rr          , Rr          , Mm          , Mm          , Hh          , Gs^Fp       , Rr          , Gs^Fp       , Gs^Fp       , Hh          , Rr          , Rr          , Gs^Vht      , Cud         , Cud         , Cud         , Mm          , Mm          , Mm          , Mm          , Mm          
Mm          ,Mm          , Hh          , Hh          , Cud         , Cud         , Rr          , Cud         , Rr          , Rr          , Gs^Fp       , Hh          , Rr          , Hh          , Gs^Fp       , Gs^Fp       , Gs^Fp       , Rr          , Gg^Vh       , Gs^Fp       , Rr          , Rr          , Rr          , Rr          , Mm          , Cud         , Cud         , Hh          , Mm          , Mm          , Mm          , Mm          
Mm          ,Mm          , Mm          , Hh          , Cud         , Cud         , Gs^Vht      , Rr          , Gs^Fp       , Gs^Fp       , Gs^Fp       , Mm          , Rr          , Hh          , Gs^Fp       , Gs^Vht      , Rr          , Rr          , Rr          , Rr          , Mm          , Hh          , Rr          , Mm          , Hh          , Cud         , Cud         , Hh          , Hh          , Mm          , Mm          , Mm          
Mm          ,Mm          , Mm          , Hh          , Cud         , Cud         , Rr          , Rr          , Rr          , Gs^Fp       , Hh          , Gs^Fp       , Gg^Vh       , Rr          , Rr          , Rr          , Cud         , Rr          , Rr          , Hh          , Hh          , Mm^Vhh      , Rr          , Hh          , Mm          , Cud         , Cud         , Hh          , Mm          , Mm          , Mm          , Mm          
Mm          ,Mm          , Mm          , Hh          , Cud         , Cud         , Cud         , Cud         , Rr          , Hh          , Gs^Fp       , Gs^Fp       , Rr          , Rr          , Rr          , Cud         , 3 Kud       , Cud         , Rr          , Mm          , Hh          , Hh          , Mm          , Rr          , Hh          , Cud         , Cud         , Hh          , Mm          , Mm          , Mm          , Mm          
Mm          ,Mm          , Mm          , Hh          , Hh          , Hh^Vhh      , Cud         , Cud         , Gs^Vht      , Rr          , Rr          , Rr          , Gs^Fp       , Hh          , Rr          , Cud         , Cud         , Cud         , Rr          , Hh^Vhh      , Hh          , Mm          , Hh          , Rr          , Rr          , Cud         , Cud         , Hh          , Mm          , Mm          , Mm          , Mm          
Mm          ,Mm          , Mm          , Hh          , Hh          , Hh          , Cud         , Cud         , Cud         , Rr          , Rr          , Gs^Fp       , Gs^Fp       , Mm          , Rr          , Rr          , Rr          , Rr          , Gs^Fp       , Rr          , Rr          , Mm          , Mm          , Rr          , Gs^Vht      , Cud         , Cud         , Hh          , Hh          , Mm          , Mm          , Mm          
Mm^Xm       ,Mm^Xm       , Mm          , Mm          , Mm          , Mm          , Hh          , Cud         , Cud         , Cud         , Cud         , Rr          , Rr          , Mm^Vhh      , Rr          , Gs^Fp       , Gs^Fp       , Gs^Fp       , Hh          , Hh          , Rr          , Rr          , Rr          , Rr          , Cud         , Cud         , Cud         , Hh          , Hh          , Hh          , Mm          , Mm          
Mm^Xm       ,Mm^Xm       , Mm          , Mm          , Mm          , Hh          , Hh          , Hh          , Hh          , Cud         , Cud         , 8 Kud       , Gs^Fp       , Rr          , Rr          , Gs^Fp       , Gs^Fp       , Hh          , Rr          , Rr          , Gs^Fp       , Gs^Fp       , Gs^Fp       , Hh          , Cud         , Cud         , Mm^Vhh      , Hh          , Mm          , Mm          , Mm          , Mm          
Mm^Xm       ,Mm^Xm       , Mm          , Mm          , Hh          , Hh          , Hh          , Hh          , Hh          , Hh^Vhh      , Cud         , Cud         , Cud         , Gs^Fp       , Rr          , Hh          , Rr          , Rr          , Hh          , Gs^Fp       , Cud         , 4 Kud       , Cud         , Cud         , Cud         , Cud         , Hh          , Mm          , Mm          , Mm          , Mm          , Mm          
Mm          ,Mm          , Hh          , Hh          , Hh          , Hh          , Mm          , Hh          , Mm          , Hh          , Hh          , Cud         , Cud         , Cud         , Cud         , Rr          , Rr          , Gg^Vh       , Cud         , Cud         , Cud         , Cud         , Cud         , Cud         , Hh          , Hh          , Mm          , Mm          , Mm          , Mm          , Mm          , Mm          
Mm          ,Mm          , Hh          , Hh          , Hh          , Mm          , Mm          , Hh          , Mm          , Mm          , Mm          , Mm^Vhh      , Cud         , Cud         , Cud         , Rr          , Rr          , Cud         , Cud         , Cud         , Hh          , Mm^Vhh      , Hh          , Hh          , Mm          , Hh          , Hh          , Mm          , Mm          , Mm          , Mm          , Mm          
Mm          ,Mm          , Mm          , Mm          , Mm          , Mm          , Mm          , Mm          , Mm          , Hh          , Hh          , Hh          , Hh          , Cud         , Hh^Vhh      , Rr          , Rr          , Hh          , Hh          , Hh          , Hh          , Mm          , Mm          , Hh          , Mm          , Hh          , Hh          , Hh          , Hh          , Mm          , Mm          , Mm          
Mm          ,Mm          , Mm          , Mm          , Mm          , Mm          , Mm          , Mm          , Mm          , Hh          , Hh          , Hh          , Hh          , Hh          , Hh          , Rr          , Rr          , Hh          , Mm          , Mm          , Hh          , Hh          , Mm          , Mm          , Hh          , Hh          , Mm          , Mm          , Mm          , Mm          , Mm          , Mm          
Mm          ,Mm          , Mm          , Mm          , Mm          , Mm          , Mm          , Mm          , Mm          , Mm          , Mm          , Hh          , Hh          , Hh          , Hh          , Rr          , Rr          , Hh          , Hh          , Mm          , Hh          , Mm          , Mm          , Mm          , Mm          , Mm          , Mm          , Mm          , Mm          , Mm          , Mm          , Mm          
Mm          ,Mm          , Mm          , Mm          , Mm          , Mm          , Mm          , Mm          , Mm          , Mm          , Hh          , Mm          , Mm          , Hh          , Hh          , Rr          , Rr          , Hh          , Mm          , Hh          , Hh          , Mm          , Hh          , Hh          , Hh          , Mm          , Mm          , Mm          , Ce          , Mm          , Mm          , Mm          
Mm          ,Mm          , Ce          , Ce          , Mm          , Mm          , Mm          , Mm          , Mm          , Mm          , Mm          , Mm          , Hh          , Hh          , Mm          , Rr          , Rr          , Hh          , Mm          , Mm          , Mm          , Hh          , Hh          , Hh          , Hh          , Mm          , Mm          , Mm          , Ce          , Ce          , Mm          , Mm          
Mm          ,Mm          , 9 Ke        , Ce          , Mm          , Mm          , Mm          , Mm          , Mm          , Mm          , Mm          , Hh          , Hh          , Mm          , Mm          , Rr          , Rr          , Hh          , Hh          , Mm          , Mm          , Mm          , Mm          , Mm          , Mm          , Mm          , Mm          , Mm          , Mm          , 5 Ke        , Mm          , Mm          
Mm          ,Mm          , Mm          , Mm          , Mm          , Mm          , Mm          , Mm          , Mm          , Mm          , Mm          , Mm          , Hh          , Hh          , Hh          , Rr          , Rr          , Hh          , Hh          , Mm          , Mm          , Mm          , Mm          , Mm          , Mm          , Mm          , Mm          , Mm          , Mm          , Mm          , Mm          , Mm          
Mm          ,Mm          , Mm          , Mm          , Mm          , Mm          , Mm          , Mm          , Mm          , Mm          , Mm          , Mm          , Hh          , Hh          , Hh          , Rr          , Rr          , Hh          , Hh          , Mm          , Mm          , Mm          , Mm          , Mm          , Mm          , Mm          , Mm          , Mm          , Mm          , Mm          , Mm          , Mm          
