border_size=1
usage=map

Mm          ,Mm          , Hh          , Rr          , Hh          , Mm          , Mm          , Mm          , Mm          , Mm          , Hh          , Hh          , Mm      , Hh          , Hh          , Hh          , Cud       , Rr          , Mm          , Mm^Xm       , Mm^Xm       , Mm^Xm       
Mm          ,Mm          , Hh          , Rr          , Hh          , Mm          , Mm          , Mm          , Mm          , Mm          , Hh          , Hh          , Mm^Vhh      , Hh          , Hh          , Hh          , 4 Kud       , Rr          , Mm          , Mm^Xm       , Mm^Xm       , Mm^Xm       
Mm          ,Mm          , Hh          , Rr          , Rr          , Hh          , Hh          , Hh          , Hh          , Hh          , Gg          , Hh          , Gs^Fp       , Gg          , Gs^Fp       , Cud         , Cud         , Hh          , Hh          , Mm^Xm       , Mm^Xm       , Mm^Xm       
Hh          ,Hh          , Hh          , Hh          , Cud         , Cud         , Cud         , Hh          , Gs^Fp       , Gs^Fp       , Gs^Fp       , Gg          , Gg          , Gs^Fp       , Gs^Fp       , Gs^Fp       , Rr          , Hh          , Hh          , Mm          , Mm^Xm       , Mm^Xm       
Hh          ,Hh          , Gg          , Gg          , Cud         , 3 Kud       , Cud         , Gs^Fp       , Gs^Fp       , Gg          , Hh          , Hh          , Hh          , Gg          , Gg          , Gs^Fp       , Rr          , Hh          , Hh          , Mm          , Mm          , Mm          
Gg          ,Gg          , Gg^Vh       , Gg          , Gs^Fp       , Rr          , Hh          , Gg          , Gg          , Hh          , Gg          , Gs^Fp       , Gg          , Hh^Vhh      , Gg          , Rr          , Gs^Fp       , Hh          , Gs^Fp       , Hh^Vhh      , Hh          , Hh          
Gg          ,Gg          , Gg          , Gs^Fp       , Gs^Fp       , Rr          , Rr          , Gg          , Gg          , Hh          , Hh          , Gg          , Gs^Fp       , Gs^Fp       , Gs^Fp       , Rr          , Gs^Fp       , Gs^Fp       , Gg          , Gg          , Gg          , Gg          
Gg          ,Gg          , Gg          , Gg          , Hh          , Hh          , Gs^Fp       , Rr          , Rr          , Gg          , Rr          , Rr          , Rr          , Rr          , Rr          , Rr          , Ww          , Gg          , Ww          , Ww          , Ww          , Ww          
Gg          ,Gg          , Gg          , Gg          , Hh          , Gs^Fp       , Hh          , Hh          , Rr          , Rr          , Hh^Vhh      , Hh          , Hh          , Hh          , Ww^Bw|      , Ww          , Wo          , Ww          , Wo          , Wo          , Wo          , Wo          
Gs^Fp       ,Gs^Fp       , Gs^Fp       , Gg          , Hh          , Hh          , Rr          , Rr          , Gs^Fp       , Gg          , Gg          , Gg          , Ww          , Ww          , Ww^Bw|      , Wo          , Wo          , Wo          , Wo          , Wo          , Ww          , Ww          
Gs^Fp       ,Gs^Fp       , Hh          , Gs^Fp       , Gs^Fp       , Gg          , Rr          , Gs^Fp       , Gs^Fp       , Gg          , Ww          , Ww          , Wo          , Wo          , Ww^Bw|      , Wo          , Ww          , Ww          , Ww          , Ww          , Gg          , Gg          
Hh          ,Hh          , Gg          , Gs^Fp       , Hh          , Gg          , Rr          , Gs^Fp       , Ww          , Ww          , Wo          , Wo          , Wo          , Ww          , Rr          , Ww          , Gg          , Gg          , Gg          , Gg          , Gs^Fp       , Gs^Fp       
Hh          ,Hh          , Hh^Vhh      , Gg          , Gs^Fp       , Hh          , Ww          , Ww^Bw\      , Ww^Bw\      , Wo          , Wo          , Wo          , Ww          , Ww          , Rr          , Gg          , Gg^Vh       , Gg          , Gs^Fp       , Gs^Fp       , Gs^Fp       , Gs^Fp       
Hh          ,Hh          , Gs^Fp       , Gs^Fp       , Ww          , Ww          , Wo          , Wo          , Wo          , Ww^Bw\      , Ww^Bw\      , Ww          , Hh          , Gs^Fp       , Gs^Fp       , Rr          , Rr          , Gs^Fp       , Gs^Fp       , Gg          , Gg          , Gg          
Gs^Fp       ,Gs^Fp       , Ww          , Ww          , Wo          , Wo          , Wo          , Wo          , Ww          , Ww          , Gg          , Rr          , Hh          , Gs^Fp       , Mm          , Gs^Fp       , Hh          , Rr          , Rr          , Hh^Vhh      , Gg          , Gg          
Ww          ,Ww          , Ww          , Ww          , Wo          , Wo          , Wo          , Ww          , Gs^Fp       , Gg^Vh       , Gg          , Rr          , Gs^Fp       , Mm          , Hh          , Mm          , Hh          , Gs^Fp       , Rr          , Gg          , Gg          , Gg          
Wo          ,Wo          , Wo          , Wo          , Wo          , Wo          , Ww          , Ww          , Gs^Fp       , Gg          , Gg          , Rr          , Hh          , Hh          , Gs^Fp       , Mm          , Gg          , Gg          , Rr          , Gs^Fp       , Gs^Fp       , Gs^Fp       
Wo          ,Wo          , Wo          , Wo          , Wo          , Wo          , Ww          , Gs^Fp       , Hh          , Hh          , Ce          , Rr          , Rr          , Gg          , Gg          , Mm^Vhh      , Rr          , Rr          , Ce          , Rr          , Rr          , Rr          
Wo          ,Wo          , Wo          , Wo          , Wo          , Wo          , Ww          , Gs^Fp       , Gg          , Ce          , 1 Ke        , Ce          , Rr          , Rr          , Rr          , Rr          , Gg          , Ce          , 2 Ke        , Gs^Fp       , Gg          , Gg          
Wo          ,Wo          , Wo          , Wo          , Wo          , Wo          , Ww          , Gg          , Gg^Vh       , Gg          , Gg          , Rr          , Hh          , Hh          , Gs^Fp       , Gg          , Gg          , Ce          , Gg          , Gg          , Gs^Fp       , Gs^Fp       
Wo          ,Wo          , Wo          , Wo          , Wo          , Wo          , Ww          , Gs^Fp       , Gs^Fp       , Gg          , Rr          , Rr          , Gs^Fp       , Gg          , Gs^Fp       , Gs^Fp       , Gs^Fp       , Gs^Fp       , Gs^Fp       , Gg^Vh       , Gs^Fp       , Gs^Fp       
Wo          ,Wo          , Wo          , Wo          , Wo          , Wo          , Ww          , Gs^Fp       , Gs^Fp       , Gg          , Rr          , Rr          , Gs^Fp       , Gg          , Gs^Fp       , Gs^Fp       , Gs^Fp       , Gs^Fp       , Gs^Fp       , Gg       , Gs^Fp       , Gs^Fp       
